
SO ./textures/wall2.xpm


NO ./textures/wall1.xpm

WE ./textures/wall4.xpm


EA ./textures/wall3.xpm


R 600 400

F 165,42,42

S ./textures/pillar.xpm
C 135,206,235


        1111111111111111111111111
        1000000000110000000000001
        1011000001110000002000001
        1001000000000000000000001
11111111101100000111000E000000001
100000000011000001110111111111111
11110111111111011100000010001
11110111111111011101010010001
11000000110101011100000010001
10002000000000001100000010001
10000000000000001101010010001
1100000111010101111101111000111
11110111 1110101 101111010001
11111111 1111111 111111111111
